{
  "name": "The Basement",
  "tiles": [
    "1111111111111111111111111",
    "1000000001000000000000001",
    "1011111001011111011110101",
    "1010001000000001000010001",
    "1010111011110001011110001",
    "1000100010010001010000001",
    "1011101110011001010111101",
    "1000001000011000000000101",
    "1111001011111011111010101",
    "1000001000001000001010001",
    "1011111011001011001011101",
    "1010000000001000001000001",
    "1010111111011111101110111",
    "1000100000000000000000001",
    "1011101111101110111111101",
    "1000001000001000100000001",
    "1011011011111010101110001",
    "1000000000000000000000021"
  ],
  "playerStart": [1.5, 1.5],
  "enemies": [
    { "type": "stalker", "tile": [5, 1] },
    { "type": "stalker", "tile": [12, 3] },
    { "type": "rusher", "tile": [3, 9] },
    { "type": "stalker", "tile": [18, 7] },
    { "type": "rusher", "tile": [9, 13] },
    { "type": "stalker", "tile": [20, 15] }
  ],
  "narrative": "The darkness below stirs. Find the exit. Don't look away."
}
