{
  "name": "The Corridors",
  "tiles": [
    "111111111111111111111111111111",
    "100000000010000000000100000001",
    "101111110010111011100101111101",
    "100000010000100010000100000001",
    "101110011111100010111101011101",
    "101000000000000010000001010001",
    "101011101111011110110001010101",
    "100010100000010000010001010101",
    "111010101111010111010111010101",
    "100010100001010001010000010101",
    "101110111001011101011111110101",
    "100000001001000100000000000101",
    "101111001001110101111101111101",
    "100001001000000100000100000001",
    "111101011111110111110101111101",
    "100001010000000000010100010001",
    "101101010111111110010111010111",
    "100100000100000000010000010001",
    "100111110101011111110111011101",
    "100000000100010000000100000001",
    "111111111111111111111111111121"
  ],
  "playerStart": [1.5, 1.5],
  "enemies": [
    { "type": "stalker", "tile": [5, 3] },
    { "type": "stalker", "tile": [15, 5] },
    { "type": "rusher", "tile": [5, 11] },
    { "type": "stalker", "tile": [23, 9] },
    { "type": "rusher", "tile": [9, 13] },
    { "type": "stalker", "tile": [25, 13] },
    { "type": "rusher", "tile": [17, 17] },
    { "type": "stalker", "tile": [8, 17] }
  ],
  "narrative": "Deeper now. The corridors twist and the lurkers multiply."
}
