{
  "name": "The Hive",
  "tiles": [
    "1111111111111111111111111111111111",
    "1000000000100000000010000000000001",
    "1011111010101110111010111111011101",
    "1010000010100000100010100000010001",
    "1010111110111110101110101111010101",
    "1000100000000000100000100001010101",
    "1110101111101111101011111001010101",
    "1000101000001000001000000001010001",
    "1010101011101010101011101111011101",
    "1010001010001010101010001000000001",
    "1011111010111010101010111011111101",
    "1000000010000010001010000000000001",
    "1011101110111111111010101111110111",
    "1010001000100000000010101000010001",
    "1010111011101110111110101011010101",
    "1010000010000010000000001010010101",
    "1011110110111010111111101010010101",
    "1000010100001010000000101010010001",
    "1110010111101011111010101011110101",
    "1000010000001000001010100000000101",
    "1011011011111011101110111111110101",
    "1000000000000000001000000000000101",
    "1111111111111111111111111111111121"
  ],
  "playerStart": [1.5, 1.5],
  "enemies": [
    { "type": "stalker", "tile": [3, 3] },
    { "type": "rusher", "tile": [13, 1] },
    { "type": "stalker", "tile": [20, 5] },
    { "type": "rusher", "tile": [7, 7] },
    { "type": "stalker", "tile": [28, 7] },
    { "type": "rusher", "tile": [13, 13] },
    { "type": "stalker", "tile": [25, 15] },
    { "type": "rusher", "tile": [4, 17] },
    { "type": "rusher", "tile": [30, 19] },
    { "type": "stalker", "tile": [15, 19] },
    { "type": "rusher", "tile": [7, 21] }
  ],
  "narrative": "The hive awakens. They sense your fear. There is no mercy here."
}
